<b>Особливості:</b>

- Швидкий доступ до улюблених програм: відображайте програми, якими найчастіше користуєтеся, на головному екрані в текстовому форматі для швидкого доступу та оптимізації ваших операцій.
- Приховати програми: легко приховуйте програми, які ви не хочете бачити, зберігаючи головний екран чистим і зосередженим на важливому вмісті.
- Перейменування додатків: персоналізуйте свої додатки за допомогою користувацьких імен, які синхронізуються між вибраним і всіма додатками.
- Блокування: захистіть свою конфіденційність і дані за допомогою блокування відбитком пальця для вибраних програм і налаштувань.
- Без доступу до Інтернету: дозволи для доступу до Інтернету не використовуються, гарантуючи, що ваші дані залишаються конфіденційними.
- Звіти про збої: повідомляйте про збої електронною поштою, включаючи файли журналу для ефективного усунення несправностей.

<b>Персоналізована настройка:</b>

- Кольори шрифту: налаштуйте кольори шрифту за допомогою нашого засобу вибору кольорів.
- Позиція: вирівняйте дату, час і програми ліворуч, по центру або праворуч.
- Відступ: налаштуйте відступ між улюбленими програмами та всіма програмами.
- Розмір шрифту: установіть розмір шрифту для кожного елемента на головному екрані.
- Перемикати елементи: керуйте параметрами відображення на головному екрані.

<b>Можливі жести:</b>

- Жести пальцем: переміщуйтесь, проводячи пальцем у різних напрямках (вгору, вниз, ліворуч, праворуч), щоб отримати доступ до різних функцій або переходити між екранами.
- Подвійний дотик: швидко двічі торкніться екрана, щоб виконати попередньо визначену дію або активувати функцію.
- Взаємодія з годинником: торкніться годинника, щоб відобразити додаткову інформацію, наприклад будильники або світовий час.
- Взаємодія з датою: торкніться дати, щоб відкрити програму календаря для розкладу та планування.
- Піктограма батареї: торкніться піктограми батареї, щоб переглянути відомості про використання батареї.

<b>Можливі дії:</b>

- Відкрити вказану програму: миттєво запускайте будь-яку вибрану програму для безперешкодного доступу до вибраного.
- Відображення списку додатків: ефективно переглядайте встановлені додатки та керуйте ними за допомогою повного відображення списку.
- Блокування екрана: захистіть свій пристрій і конфіденційність за допомогою швидкого та зручного блокування екрана.
- Показувати нещодавно відкриті програми: легко відкривайте нещодавно використані програми для швидкої багатозадачності.
- Доступ до ящика сповіщень: відкривайте ящик сповіщень одним дотиком, щоб перевірити оновлення та сповіщення.
- Швидкі налаштування: швидко керуйте налаштуваннями пристрою, відкриваючи швидкі налаштування безпосередньо з головного екрана.
- Діалогове вікно живлення: легко керуйте параметрами живлення, такими як перезапуск, вимкнення тощо, за допомогою діалогового вікна живлення.
- Зробіть знімок екрана: миттєво зробіть знімок екрана, щоб зберегти та поділитися важливою інформацією та моментами.
- Вимкнути жести: тимчасово або назавжди вимкніть певні жести, щоб налаштувати взаємодію з пристроєм.

<b>Permissions:</b>

- android.permission.SET_WALLPAPER: This permission is needed for the app to change or set the device's wallpaper. It allows the app to programmatically modify the wallpaper displayed on the home or lock screen.
- android.permission.EXPAND_STATUS_BAR: This permission allows the app to expand or collapse the status bar, providing functionality to interact with the quick settings or notifications.
- android.permission.USE_BIOMETRIC: This permission is needed for the app to use biometric authentication methods (such as fingerprint, face recognition, or iris scanning).
- android.permission.VIBRATE: This permission allows the app to control the device’s vibrator to provide haptic feedback, which can be used for alerts, notifications, or custom user interactions within the app.
- android.permission.QUERY_ALL_PACKAGES: This permission allows the app to query and view the list of all installed apps on the device. This permission can raise privacy concerns and is often reviewed by Google Play for appropriate use.
- android.permission.REQUEST_DELETE_PACKAGES: This permission allows the app to request the uninstallation of packages (apps) from the device.This permission is highly restricted and usually only granted to system-level or enterprise apps.
- com.android.alarm.permission.SET_ALARM: This permission is necessary for an app to set alarms on the device. It allows the app to schedule alarms that will trigger at specific times, commonly used by clock, reminder, or task apps.

Щоб дізнатися більше, відвідайте сторінку <a href="https://github.com/DroidWorksStudio/EasyLauncher/blob/main/README.md">Github</a> .