<b>תכונות:</b>

- גישה מהירה לאפליקציה מועדפת: הצג את האפליקציות הנפוצות ביותר שלך במסך הבית בפורמט טקסט לגישה מהירה, לייעל את הפעולות שלך.
- הסתר אפליקציות: הסתר בקלות אפליקציות שאינך רוצה שיוצגו, שמירה על מסך הבית שלך נקי וממוקד בתוכן חיוני.
- שנה שם אפליקציות: התאם אישית את האפליקציות שלך עם שמות מותאמים אישית המסונכרנים בצורה חלקה בין המועדפים וכל האפליקציות.
- נעילה: אבטח את הפרטיות והנתונים שלך עם נעילת טביעת אצבע עבור אפליקציות והגדרות נבחרות.
- ללא הרשאות אינטרנט: אין שימוש בהרשאות אינטרנט, מה שמבטיח שהנתונים שלך יישארו פרטיים.
- דוחות קריסה: דווח על קריסות באמצעות דואר אלקטרוני, כולל קובצי יומן לפתרון בעיות יעיל.

<b>התאמה אישית:</b>

- צבעי גופן: התאם אישית את צבעי הגופן באמצעות בורר הצבעים שלנו.
- מיקום: יישר תאריך, שעה ואפליקציות לשמאל, למרכז או לימין.
- ריפוד: התאם ריפוד בין האפליקציות המועדפות לכל האפליקציות.
- גודל גופן: הגדר גודל גופן עבור כל רכיב במסך הבית.
- החלף בין פריטים: שליטה בהעדפות התצוגה במסך הבית.

<b>מחוות אפשריות כוללות:</b>

- תנועות החלקה: נווט על ידי החלקה בכיוונים שונים (מעלה, למטה, שמאלה, ימינה) כדי לגשת לתכונות שונות או לעבור בין מסכים.
- הקשה כפולה: הקש במהירות פעמיים על המסך כדי לבצע פעולה מוגדרת מראש או להפעיל תכונה.
- אינטראקציית שעון: הקש על השעון כדי להציג מידע נוסף כגון אזעקות או שעון עולמי.
- אינטראקציה עם תאריך: הקש על התאריך כדי לפתוח את אפליקציית לוח השנה לתזמון ותכנון.
- סמל סוללה: הקש על סמל הסוללה כדי לגשת לפרטי השימוש בסוללה.

<b>פעולות אפשריות כוללות:</b>

- פתח את האפליקציה שצוינה: הפעל מיידית כל אפליקציה שתבחר לגישה חלקה למועדפים שלך.
- הצג רשימת אפליקציות: הצג ונהל את האפליקציות המותקנות שלך ביעילות עם תצוגת רשימה מקיפה.
- נעילת מסך: אבטח את המכשיר שלך והגן על פרטיותך עם נעילת מסך מהירה ונוחה.
- הצג אפליקציות שנפתחו לאחרונה: גש לאפליקציות שבהן השתמשת לאחרונה ללא מאמץ לריבוי משימות מהיר.
- גישה למגירת הודעות: פתח את מגירת ההודעות בלחיצה אחת כדי לבדוק עדכונים והתראות.
- הגדרות מהירות: נהל את הגדרות המכשיר במהירות על ידי גישה להגדרות מהירות ישירות ממסך הבית.
- דיאלוג הפעלה: שליטה באפשרויות ההפעלה כגון הפעלה מחדש, כיבוי ועוד בקלות באמצעות תיבת ההפעלה.
- צלם צילום מסך: צלם את המסך שלך באופן מיידי כדי לשמור ולשתף מידע ורגעים חשובים.
- השבת מחוות: השבת באופן זמני או לצמיתות מחוות ספציפיות כדי להתאים אישית את חוויית האינטראקציה במכשיר שלך.

<b>Permissions:</b>

- android.permission.SET_WALLPAPER: This permission is needed for the app to change or set the device's wallpaper. It allows the app to programmatically modify the wallpaper displayed on the home or lock screen.
- android.permission.EXPAND_STATUS_BAR: This permission allows the app to expand or collapse the status bar, providing functionality to interact with the quick settings or notifications.
- android.permission.USE_BIOMETRIC: This permission is needed for the app to use biometric authentication methods (such as fingerprint, face recognition, or iris scanning).
- android.permission.VIBRATE: This permission allows the app to control the device’s vibrator to provide haptic feedback, which can be used for alerts, notifications, or custom user interactions within the app.
- android.permission.QUERY_ALL_PACKAGES: This permission allows the app to query and view the list of all installed apps on the device. This permission can raise privacy concerns and is often reviewed by Google Play for appropriate use.
- android.permission.REQUEST_DELETE_PACKAGES: This permission allows the app to request the uninstallation of packages (apps) from the device.This permission is highly restricted and usually only granted to system-level or enterprise apps.
- com.android.alarm.permission.SET_ALARM: This permission is necessary for an app to set alarms on the device. It allows the app to schedule alarms that will trigger at specific times, commonly used by clock, reminder, or task apps.

לפרטים נוספים בקר בדף <a href="https://github.com/DroidWorksStudio/EasyLauncher/blob/main/README.md">Github</a> .